        WE ./map_textures/WE.png
SO ./map_textures/SO.png
        NO      ./map_textures/NO.png

        C   225, 	 30	,0  
EA      ./map_textures/EA.png

  F              220,  100 ,  0
 

        111111111111111111111111
        100000000011000000001001
        1011000001110000000001011
        1001000000000000000000001
111111111011000001110000000000001
100000000010000001110111111111101
11110111100001111100000010001 111
111101111111111  101010010001  11
110000001101111  111110010001   1  
1000000000001        10010001
1000000000011        10010001
111110111111  11 111 11110N0111
10000001     101 101111010001
11111111 1111111 111111111011
                   11
          