        WE ./textures/WE.png
SO ./textures/SO.png
        NO      ./textures/NO.png

  C              220,  100 ,  0
EA      ./textures/EA.png

        F   225, 	 80	,50  
 
     0 1      1     0       0 
          111111111111111111111111	
          1         11         1	
          1 11000001110000000001111
 0        1  1000000000000000000001
  111111111 11000001110000000000001
  1         10000001110111110111101
  1111 1111    1111100000010001 111   1
  1111 1111111111  101010010001  11
  11      11  111  111110010001   1  
  1           1        100100011
  1           1        10010001 1
  11111 111111  11 111 11110N0101
  1      1     101 10111101000  1
  11111111 1111111 11100001111111
  1
                    111111111111111111
          